ability = Fähigkeit, Eignung, Können
action = Handlung, Tat, Aktion
activity = Beschäftigung, Aktivität
address = Adresse
adult = Erwachsener
age = Alter
agreement = Zustimmung, Einigung, Vereinbarung
air = Luft
airport = Flughafen
amount = Menge, Umfang, Betrag
animal = Tier
answer = Antwort
area = Gegend, Gebiet
argument, quarrel = Streit
arm = Arm
art = Kunst
article = Artikel, Ware, Gegenstand
attention = Aufmerksamkeit
audience = Zuschauer, Publikum
back = Rücken, Rückseite
bag = Tasche, Beutel
bakery = Bäckerei
bank = Bank
bed = Bett
bedroom = Schlafzimmer
beer = Bier
behaviour = Verhalten
benefit = Nutzen, Vorteil
bike = Fahrrad
bill = Rechnung
blood = Blut
body = Körper, Leiche
book = Buch
box = Kiste, Schachtel
boy = Junge
bread = Brot
brother = Bruder
brother-in-law = Schwager
building = Gebäude
bus = Bus
business = Geschäft
cancer = Krebs
capital = Hauptstadt
car = Auto
card = Karte (Visiten-)
career = Karriere, Werdegang
cause = Grund, Ursache
century = Jahrhundert
chair = Stuhl
challenge = Herausforderung
chance = Gelegenheit, Zufall
front = Vorderseite, Vorderteil
child = Kind
choice = Wahl
church = Kirche
cinema = Kino
citizen = Bürger
city = (Groß-)Stadt
cloud = Wolke
collection = Sammlung
colour = Farbe
community = Gemeinde, Gemeinschaft
company = Begleitung; Firma
condition = Bedingung
cost = Kosten
country = Land
countryside = ländlicher Raum
course = Kurs; Verlauf
court = Hof, Hinterhof; Gericht
crime = Verbrechen
cup = Tasse
daughter = Tochter
day = Tag
death = Tod
decade = Jahrzehnt
decision = Entscheidung
defense / defence = Verteidigung
degree = Maß, Ausmaß, Grad
development = Entwicklung
difference = Unterschied
difficult = schwierig
direction = Richtung
discussion = Diskussion
disease = Krankheit
doctor = Doktor
dog = Hund
door = Tür
dream = Traum
drug = Droge, Medikament
east = Osten
edge = Rand, Kante
education = Bildung
effect = Auswirkung, Effekt
effort = Anstrengung
election= Wahl
elevator = Aufzug
employee = Angestellter
enemy = Feind
energy = Energie
grandson = Enkel(sohn)
granddaughter = Enkeltochter
environment = Umwelt, Umfeld, Umgebung
evening = Abend
event = Ereignis, Vorfall
evidence = Beweis
example = Beispiel
experience = Erfahrung
eye = Auge
face = Gesicht
fact = Fakt, Tatsache
family = Familie
father = Vater
fear = Angst
feeling = Gefühl
figure = Gestalt, Figur, Zahl
finger = Finger
fire = Feuer
fish = Fisch
floor = Fußboden; Etage
fog = Nebel
food = Essen, Lebensmittel
foot = Fuß
Friday = Freitag
friend = Freund
fund = Fonds
future = Zukunft
game = Spiel
garden = Garten
gas station (AE) = Tankstelle
girl = Mädchen
glass = Glas
goal = Ziel; Tor
government = Regierung
ground = Boden, Gelände
group = Gruppe
growth = Wachstum
gun = Gewehr
guy = Typ, Kerl
hair = Haar/e
hand = Hand
head = Kopf
heart = Herz
heat = Hitze
history = Geschichte
hit = Treffer, Schlag
home = Zuhause; Heimat
hospital = Krankenhaus
hotel = Hotel
hour = Stunde
house = Haus
husband = Ehemann
idea = Idee
image = Bild, Vorstellung
impact = Auswirkung, Aufprall
interest = Interesse; Zins
item = Gegenstand, Objekt
juice = Saft
key = Schlüssel
kindergarten, nursery school = Kindergarten
kitchen = Küche
knowledge = Wissen
lake = See
land = Land
language = Sprache
law = Gesetz
lawyer = Anwalt
leg = Bein
legal = gesetzlich, legal
letter = Brief, Buchstabe
life = Leben
line = Linie, Zeile
list = Liste
loss = Verlust
majority = Mehrheit
man = Mann
market = Markt
marriage = Ehe
matter = Angelegenheit, Anliegen
measure = Maß, Ausmaß
meat = Fleisch
memory = Erinnerung
message = Nachricht, Mitteilung
method = Methode
middle = Mitte, Zentrum
milk = Milch
minute = Minute
moment = Augenblick, Moment
Monday = Montag
money = Geld
month = Monat
morning = Morgen
mother = Mutter
mountain = Berg
mouth = Mund
movement = Bewegung
movie = Film
music = Musik
name = Name
nature = Natur
nephew = Neffe
news = Nachricht
newspaper = Zeitung
niece = Nichte
night = Nacht
noon = Mittag
north = Norden
number = Zahl, Nummer
offer = Angebot
office = Büro
oil = Öl
opportunity = Möglichkeit, Gelegenheit
order = Befehl; Reihenfolge; Bestellung
owner = Eigentümer
page = Seite
pain = Schmerz
painting = Gemälde; Anstrich
paper = Papier
parents = Eltern
part = Teil
participant = Teilnehmer
party = Party
patience = Geduld
pattern = Muster
peace = Friede
people = Leute
performance = Leistung
person = Person
petrol station (BE) = Tankstelle
pharmacy = Apotheke
picture = Bild
piece = Stück
place = Ort, Stelle
plane = Flugzeug
plant = Pflanze; Betrieb, Fabrik
player = Spieler
police = Polizei
policy = Bestimmung, Grundsatz
population = Bevölkerung
port = Hafen
position = Lage, Position, Stellung
power = Macht; Strom
president = Präsident
pressure = Druck
price = Preis
problem = Problem
process = Prozess, Vorgang
product = Produkt
production = Produktion
project = Projekt, Vorhaben
property = Besitz
purpose = Zweck, Ziel, Absicht
quality = Qualität
question = Frage
radio = Radio, Funk
railway station = Bahnhof
rain = Regen
range = Reichweite
reality = Wirklichkeit, Realität
reason = Grund; Vernunft
record = Bericht, Aufzeichnung; Rekord
region = Region, Gebiet
relationship = Beziehung
resource = Quelle, Resource
response = Antwort
responsibility = Verantwortung
restaurant = Restaurant
restroom (AE) = Toilette
result = Ergebnis
risk = Risiko
river = Fluss
road = Straße
rock = Fels
role = Rolle, Funktion, Aufgabe
room = Zimmer
Saturday = Samstag
scene = Schauplatz; Szene
school = Schule
science = Wissenschaft
sea = Meer
season = Jahreszeit
seat = Sitz
second = Sekunde
security = Sicherheit
series = Folge, Serie, Reihe
service = Dienst; Service
ship = Schiff
shot = Schuss
shoulder = Schulter
side = Seite, Rand
sign = Zeichen
sister = Schwester
sister-in-law = Schwägerin
site = Grundstück, Stätte, Standort
situation = Situation
size = Größe
skill = Fähigkeit, Können
skin = Haut
smile = Lächeln
soldier = Soldat
son = Sohn
song = Lied
sound = Geräusch, Klang
soup = Suppe
source = Quelle, Ursprung
south = Süden
space = Platz, Raum
speech = Rede
sport = Sport
spring = Frühling
staff = Personal, Belegschaft
stage = Bühne; Phase
standard = Standard
star = Stern
state = Zustand; Bundesland; Staat
statement = Aussage, Erklärung
step = Stufe, Schritt
stepbrother = Stiefbruder
stepsister = Stiefschwester
stock = Vorrat
store = Geschäft
storm = Sturm
story = Geschichte
stream = Bach
street = Straße
structure = Struktur; Gliederung; Gebäude
student = Student, Schüler
stuff = Zeug, Kram
style = Stil
subject = Thema, Fach
subway = U-Bahn
success = Erfolg
summer = Sommer
sun = Sonne
Sunday = Sonntag
support = Unterstützung
surface = Oberfläche
system = System, Methode
table = Tisch
task = Aufgabe
tax = Steuer
teacher = Lehrer
term = Begriff; Semester
theory = Theorie
thing = Ding, Sache
thought = Gedanke
threat = Bedrohung
Thursday = Donnerstag
time = Zeit
toilet = Toilette
towel = Handtuch
town = Stadt
trade = Handel; Gewerbe, Handwerk
trail = Pfad, Wanderweg
train = Zug
treat = Leckerei
treatment = Behandlung
tree = Baum
trip = Reise, Ausflug
trouble = Ärger
truth = Wahrheit
Tuesday = Dienstag
type = Art, Typ, Sorte
uncle = Onkel
value = Wert
vegetables = Gemüse
victim = Opfer
view = Aussicht, Blick; Standpunkt
village = Dorf, Ort
violence = Gewalt
voice = Stimme
wall = Wand, Mauer
war = Krieg
water = Wasser
way = Art, Weise, Weg
weapon = Waffe
Wednesday = Mittwoch
week = Woche
weekend = Wochenende
weight = Gewicht
west = Westen
wife = Ehefrau
wind = Wind
window = Fenster
wine = Wein
woman = Frau
word = Wort
work = Arbeit
worker = Arbeiter
world = Welt
year = Jahr
can = können
could = könnte
may = dürfen, können
must = müssen
should = sollte
to accept = akzeptieren
to act = handeln, verhalten
to add = hinzufügen
to admit = zugeben
to affect = etwas beeinflussen, sich auswirken auf etwas
to agree to / with = zustimmen
to allow = zulassen
to appear = scheinen, den Anschein haben, aussehen
to apply something = anwenden, einsetzen
to approach = sich nähern, herankommen, nahen
to argue (with / against) = argumentieren
to arrive (at) = ankommen
to ask something = etwas fragen
to assume = annehmen, vermuten
to attack = angreifen
to avoid = verindern, vermeiden

to be = sein
to be able to = fähig sein zu
to be available = verfügbar sein
to beat = schlagen
to become = werden
to begin something = etwas anfangen, beginnen
to believe in something / someone = an etwas / jemanden glauben
to break = brechen
to bring = bringen
to build something = etwas bauen
to buy something = etwas kaufen


to call = rufen
to call someone = jemanden anrufen
to care for = sich kümmern um
to carry = tragen
to catch = fangen
to cause = verursachen
to change = ändern
to charge = berechnen; aufladen
to check = kontrollieren, prüfen
to choose = (aus-)wählen
to claim = fordern, beanspruchen
to close = schließen
to come = kommen
to compare = vergleichen
to consider = erwägen, berücksichtigen
to contain = beinhalten
to continue = fortfahren, weitermachen
to control = kontrollieren; beherrschen
to cover = bedecken, abdecken
to create = erschaffen
to cut something = etwas schneiden


to deal (with) = sich mit etwas befassen, mit etwas / jdm zu tun haben
to decide = entscheiden
to describe = beschreiben
to design = entwerfen, gestalten
to determine = bestimmen, festlegen
to develop = entwickeln
to die = sterben
to discover = entdecken
to do something = etwas tun, erledigen
to draw = zeichnen; auslosen
to dream = träumen
to drive = fahren (am Steuer)
to drop = fallen lassen


to eat something = etwas essen
to enjoy = genießen
to enter = eintreten, betreten
to establish = herstellen (z.B. Kontakt), einrichten
to exist = existieren
to expect = erwarten
to explain = erklären


to fail = scheitern
to fall = fallen, stürzen
to feel = fühlen, sich anfühlen
to feel good = sich gut fühlen
to fight = kämpfen
to fill = füllen
to find = finden
to finish = beenden, fertigstellen
to fly = fliegen
to follow = folgen
to forget = vergessen
to form = formen, bilden


to get along with someone = mit jemandem auskommen
to get away = entfliehen, entkommen
to get something from someone = etwas von jemandem bekommen
to get up = aufstehen (z. B. morgens, aus dem Bett)
to give = geben
to go = gehen, fahren
to go for a walk = spazieren gehen
to grow = wachsen
to guess = raten


to happen = passieren, geschehen
to have something = etwas haben
to have to do something = etwas tun müssen
to hear something = etwas hören
to help = helfen
to help someone out = jemandem aushelfen, einspringen
to help someone with something = jemandem mit etwas helfen
to hit = schlagen
to hold = halten
to hope = hoffen


to imagine = sich vorstellen
to improve = verbessern
to include = enthalten, beinhalten
to increase = erhöhen, steigern
to indicate = anzeigen, andeuten
to involve = einbeziehen
to issue = herausgeben, ausstellen


to keep something = etwas halten, behalten
to kill someone = jemanden ermorden, töten
to know someone = jemanden kennen


to lay = legen
to lead = führen
to learn something = etwas lernen
to leave = weggehen, verlassen
to let = lassen
to lie = liegen; lügen
to like something / someone = etwas / jemanden mögen
to listen to someone = jemandem zuhören
to listen to something = etwas anhören
to live = leben, wohnen
to look = blicken, schauen
to lose something = etwas verlieren
to love = lieben


to maintain = erhalten, instand halten
to make a chair = einen Stuhl machen
to make a mistake = einen Fehler machen
to make something = etwas machen, herstellen
to manage = führen, leiten, regeln
to marry = heiraten
to mean = bedeuten, meinen
to measure = messen
to meet someone jemanden treffen, kennenlernen
to mention = erwähnen
to miss = vermissen; verpassen
to move = sich bewegen


to need something = etwas brauchen
to notice = bemerken


to occur (to someone) = auftreten, ereignen
to offer = anbieten
to open something = etwas öffnen, aufmachen
to order = bestellen, befehlen
to own = besitzen


to pass = vorbeigehen; bestehen
to pay (for) something = (für) etwas bezahlen
to pay someone = jemanden bezahlen, entlohnen
to pay something off = etwas abbezahlen
to perform = vorführen; leisten
to plan = planen
to play = spielen
to practice = üben, betreiben
to prepare = vorbereiten, zubereiten
to prevent = verhindern
to process = verarbeiten
to produce = produzieren
to protect = schützen
to prove = beweisen
to provide = bereitstellen
to pull = ziehen
to push = schieben
to put = setzen, stellen, legen
to put something on the table = etwas auf den Tisch legen


to reach someone / something = jemanden / etwas erreichen
to read = lesen
to realize = merken, erkennen
to receive = erhalten
to recognize = erkennen
to reduce = verringern, reduzieren
to reflect = nachdenken, überlegen
to relate = zuordnen, etwas in Zusammenhang bringen
to remain = übrigbleiben, verbleiben
to remember = erinnern
to remove = entfernen
to report = berichten
to require = benötigen
to respond = antworten
to rest = ausruhen
to return = zurückkehren, umkehren
to reveal = verraten, enthüllen
to rise = aufsteigen, ansteigen
to risk = riskieren
to run = rennen, laufen


to save = sparen; retten
to say something = etwas sagen
to see = sehen
to sell = verkaufen
to send = senden, schicken
to sense = fühlen, spüren
to shake = schütteln
to share = teilen
to shoot = schießen
to shout = schreien, brüllen
to shout at someone = jemanden anschreien
to show = zeigen
to show off = angeben, prahlen
to show someone something = jemandem etwas zeigen
to sing = singen
to sit = sitzen
to sit on something = auf etwas sitzen
to smile = lächeln
to sort = sortieren, ordnen
to sound = klingen
to speak = sprechen
to speak about something = über etwas sprechen
to speak up = lauter sprechen
to spend = ausgeben; verbringen
to stand = stehen
to stand up = aufstehen (z. B. von einem Stuhl)
to start = beginnen, anfangen, starten
to stay = bleiben
to stop = anhalten, stoppen
to study = lernen, studieren
to succeed = gelingen, erfolgreich sein
to suffer = leiden, ertragen
to suggest = vorschlagen
to support = unterstützen
to take something = etwas nehmen
to talk about something / someone = über etwas / jemanden reden
to talk someone into something = jemanden zu etwas überreden
to talk to someone = sich mit jemandem unterhalten
to teach = lehren
to tell someone something = jemandem etwas erzählen / mitteilen
to tend to = zu etwas neigen, zu etwas tendieren
to thank = danken
to think = denken, meinen, glauben
to throw = werfen
to travel = reisen
to treat = behandeln
to try = versuchen, probieren
to turn = (sich) umdrehen, wenden
to understand = verstehen
to use something = etwas benutzen, gebrauchen
to visit = besuchen
to vote = wählen, abstimmen
to wait = warten, abwarten
to wait for someone = auf jemanden warten
to walk = zu Fuß gehen
to want something = etwas wollen
to watch = zuschauen, etwas anschauen
to watch someone = jemanden beobachten, auf jemanden aufpassen
to wear = tragen, anhaben
to win someone over = jemanden für sich gewinnen
to win something = etwas gewinnen, siegen
to wish = wünschen
to wonder = sich fragen, wundern
to work = arbeiten
to worry = sich sorgen, besorgt sein
to write something = etwas schreiben
affectionate = liebevoll, herzlich
alone = allein
ambitious = ehrgeizig
anxious = ängstlich
available = verfügbar
away = weg, fort
awesome = fantastisch, großartig
bad = schlecht
beautiful = wunderschön
big = groß
black = schwarz
blue = blau
bold = frech, dreist
boring = langweilig
brown = braun
calm = ruhig, still, unbewegt
candid = offen, ehrlich, aufrichtig
canny = schlau, geschickt, gerissen
careful = vorsichtig
central = zentral
certain = sicher, bestimmt
cheap = billig
chubby = mollig
clean = sauber
clear = klar, deutlich
clever = klug, schlau
close = nah, in der Nähe
cloudy = bewölkt, trüb
clumsy = ungeschickt, tollpatschig
cold = kalt
confident = zuversichtlich
confusing = verwirrend
content = zufrieden
crooked = schief, schräg
curious = neugierig
current = aktuell, gegenwärtig
dangerous = gefährlich
dark = dunkel
dead = tot
decent = anständig, ehrbar
deep = tief
delicious = köstlich
different = anders, unterschiedlich
dirty = dreckig
dishonest = verlogen
dry = trocken
dull = langweilig, glanzlos
eager = eifrig
early = früh
easy = leicht, einfach
educated = gebildet
empty = leer
energetic = energisch, tatkräftig
enormous = enorm, riesig
enough = genug
entire = ganz, vollständig
evil = böse
excited = aufgeregt
experienced = erfahren
faithful = treu
fake = falsch, gefälscht
fast = schnell
final = endgültig
firm = fest
flat = flach, eben
foreign = fremd
former = ehemalig
free = frei, ungebunden
fresh = frisch
friendly = freundlich
full = voll
funny = lustig
genuine = wahr, echt
glad = froh
good = gut
good-looking = gutaussehend
grateful = dankbar
great = groß, großartig
greedy = gierig
green = grün
half = halb

handsome = gutaussehend, attraktiv (männlich)
happy = glücklich
hard = hart, fest, schwierig
hardworking = fleißig
healthy = gesund
heavy = schwer
helpful = hilfsbereit
helpless = hilflos
high = hoch
honest = ehrlich
horrible = furchtbar
hot = heiß
huge = riesig
human = menschlich
impassive = teilnahmslos
important = wichtig
indifferent = desinteressiert, gleichgültig
insecure = unsicher
interesting = interessant
international = international
just = gerecht
kind = freundlich, nett
large = groß
late = spät
light = leicht; hell
likely = wahrscheinlich
little = klein, wenig
local = vor Ort, örtlich
long = lang
low = niedrig
main = haupt-
major = groß, hauptsächlich
many = viele
medical = medizinisch
modern = modern
modest = bescheiden
moist = feucht
more = mehr
much = viel
narrow = eng, schmal
natural = natürlich
necessary = notwendig
new = neu
next = nächste/r/s
nice = nett
noisy = laut, geräuschvoll
official = offiziell
old = alt
open = offen
open-minded = aufgeschlossen, vorurteilsfrei
patient = geduldig
personal = persönlich
physical = körperlich
pointed = spitz zulaufend
poisonous = giftig
political = politisch
poor = arm
popular = beliebt
positive = positiv
possible = möglich
powerful = mächtig
pretty = hübsch (weiblich)
private = privat
professional = beruflich; fachmännisch
public = öffentlich, staatlich
punctual = pünktlich
quiet = leise
rainy = regnerisch
ready = fertig, bereit
real = wirklich
red = rot
reliable = zuverlässig
religious = religiös
rich = reich
ridiculous = lächerlich
rough = grob, rauh, uneben
round = rund, rundlich
rude = unhöflich
safe = sicher
self-confident = selbstbewusst
self-conscious = befangen, gehemmt
serious = ernst
sharp = spitz, scharf, schrill
short = kurz
significant = bedeutsam
similar = ähnlich
simple = einfach
single = einzeln
slow = langsam
small = klein
smart = klug
snowy = verschneit
social = gesellschaftlich
soft = weich, sanft
sour = sauer
southern = südlich
special = speziell
specific = bestimmt, gezielt
steep = steil
still = still
stormy = stürmisch
straight = gerade
strong = stark, kräftig, stabil
stupid = dumm
successful = erfolgreich
sunny = sonnig
superficial = oberflächlich
sure = sicher, gewiss
sweet = süß
sympathetic = mitfühlend, verständnisvoll
tall = groß (z. B. Körpergröße)
tender = zart, weich
terrible = furchtbar, schrecklich
thick = dick
thin = dünn
thrilling = spannend
tidy = aufgeräumt, ordentlich
tiny = winzig klein
tired = müde
total = gesamt, völlig, gänzlich
tough = rauh, zäh, hart
true = wahr
trustworthy = vertrauenswürdig
ugly = häßlich
uneducated = ungebildet
unhealthy = ungesund
unjust = ungerecht
unlike = ungleich
valuable = wertvoll
various = verschiedenartig
warm = warm
weak = schwach, kraftlos
western = westlich
wet = nass
white = weiß
whole = ganz, vollständig
wide = breit
windy = windig
wonderful = wunderbar
wrong = falsch
yellow = gelb
young = jung
youthful = jugendlich
about = etwa, ungefähr, circa
above = darüber, oberhalb
according to = gemäß, zufolge, laut
actually = tatsächlich
after = nach, hinterher
again = wieder, noch einmal
against = gegen
ago = vor (einem Monat - a month ago)
ahead = voran, voraus
all = alle, alles, völlig, ganz
almost = fast
already = schon
also = auch
although = obwohl
always = immer
among = unter, inmitten
and = und
another = noch einer/s/e
anyone = irgendjemand
anything = irgendetwas
around = herum, um. ungefähr
as = so, wie, genauso
because = weil
before = vorher
behind = hinter
better = besser
between = zwischen
beyond = jenseits von
both = beide
but = aber
certainly = sicherlich, gewiss
despite = trotz
down = unten, hinunter
during = während
each = jede/r/s
especially = besonders
even = sogar
ever = jemals
every = jede/r/s
exactly = genau
far = weit
few = wenige
finally = endlich, schließlich
first = zuerst
forward = vorwärts
from = von, aus
general = allgemein
here = hier
how = wie
however = jedoch
if = wenn, falls
including = einschließlich, inklusive
indeed = in der Tat, allerdings
inside = innen
instead of = anstatt
into = hinein
left = links
maybe = vielleicht
near = nah, in der Nähe
nearly = beinahe, fast
never = nie
no = nein
none = keine/r/s
not = nicht
nothing = nichts
now = jetzt
obviously = offenbar, offensichtlich
of = von, an, aus
often = oft
on = an, auf, in; eingeschaltet
once = einmal
only = nur
onto = auf, auf etwas
or = oder
others = andere
out = aus, außen
outside = draußen
over = über; vorbei
overall = insgesamt
particularly = besonders
past = vergangen, vorbei; Vergangenheit
perhaps = vielleicht
present = Gegenwart; Geschenk; gegenwärtig
probably = wahrscheinlich
quickly = schnell
quite = ziemlich
rather = lieber
really = wirklich
recently = kürzlich
right = rechts; richtig
same = gleich
senior = ältere/r/s
several = einige
since = seit; weil
some = etwas, manche, einige
something = etwas
sometimes = manchmal
soon = bald
suddenly = plötzlich
than = als
that = dass
then = dann, danach, damals
there = da, dort
therefore = daher, deshalb
these = diese/r/s (Plural)
this = diese/r/s
those = diese (Plural)
though = aber, jedoch
through = durch
throughout = durchweg, die ganze Zeit
thus = dadurch, demnach
today = heute
together = zusammen
tonight = heute Abend
too = zu (zu teuer - too expensive)
under = unter
until = bis
up = hinauf, nach oben
usually = normalerweise
very = sehr
what = was
when = wann
where = wo
whether = ob
which = welche/r/s
while = während
who = wer
whose = wessen
why = warum
with = mit
within = innerhalb
without = ohne
yes = ja
yet = schon, dennoch
